################################################################
#<.............................................................#
#..............................................................#
#..............................................................#
#..............................................................#
#..............................................................#
#..............................................................#
#..............................................................#
#..............................................................#
#..............................................................#
#..............................................................#
#..............................................................#
#..............................................................#
################################################################

1 Hint