#############################
#<....B...................#1#
#.........................###
#...............L...........#
#..M..................M.....#
#...........................#
#...M...............M.......#
#...........................#
#...............M...........#
#...M..M...............L....#
#....LL........M............#
#......L.................k..#
#............L..............#
#############################

1 Hint